######  ### 
#oo  # ## ##
#oo  ### A #
#oo     @@ #
#oo  # # @ #
#oo### # @ #
#### @ #@  #
   #  @# @ #
   #  ##   #
   #########
