        ######## 
        #      # 
        #     ## 
        #     #  
        ##    #  
#########     ###
#      ##  A    #
##         @    #
#      ##########
########         
