 ###  #############
## ####       #   #
# A@   @@  @ @ ooo#
# @@@@#    @  #ooo#
# @   # @@ @@ #ooo#
###   #  @    #ooo#
#     # @ @ @ #ooo#
#    ###### ###ooo#
## #  #  @ @  #ooo#
#  ## # @@ @ @##oo#
# oo# #  @      #o#
# oo# # @@@ @@@ #o#
##### #       # #o#
    # ######### #o#
    #           #o#
    ###############      