######  ### 
#oo  # ##A##
#oo  ###   #
#oo     @@ #
#oo  # # @ #
#oo### # @ #
#### @ #@  #
   #  @# @ #
   #  ##   #
   #########