Level 1
        ########
        #     A#
        #     ##
        #  @  #
        ##    #
#########     ###
#      ##       #
##         o    #
#      ##########
########